111111
101301
101801
100001
101101
111111
1,3
1,1